111111111111111111111111111111
111111111111111111111111111111
111100000001111111111111111111
111100000001111111111111111111
111100000001111111111111111111
111100000001111111111111111111
111100000000000000000000111111
111100000000000000000000111111
111100000000000000000000111111
111100000000000000000000111111
111111111111111110000000111111
111111111111111110000000111111
111111111111111110000000111111
111111111111111110000000111111
111111111111111110000000111111
111111111111111110000000111111
111100000000000000000000111111
111100000000000000000000111111
111100000000000000000000111111
111100000000000000000000111111
111100000001111111111111111111
111100000001111111111111111111
111100000001111111111111111111
111100000001111111111111111111
111100000000000000000000111111
111100000000000000000000111111
111100000000000000000000111111
111100000000000000000000111111
111111111111111111111111111111
111111111111111111111111111111